XXXXXXXXXXXXXXXXXXXXXXXXXXXXXXXXXXXXXXXX
X       XXXXX                 XXXXXXXXXX
X       XXXXXX XXXXXXXX        XXXXXXXXX
X XXXX         XXXXXXXXXXX XXXXXXXXXXXXX
X XXXXXXXXXXXX XXXXXXXXXXX XXXXXXXXXXXXX
X XXXXX    XX     XXXXXX             XXX
X XXXXX    XX     XXXXXX XXXXXXXXXXXXXXX
X XXXXXXXX XX     XXXXXX XXXXXXXXXXXXXXX
X       XX     XXXXXXXXX      XXXXXXXXXX
X       XXXXXX XXXXXXXXXXXXXX XXXXXXXXXX
X       XXXXXX XXXXX     XXXX XXXXXXXXXX
X       XXXXX     XX             XXXXXXX
XXXX XXXXXXXXXXBXXXX     XX      XXXXXXX
XXXX      XXXXXXXXXXXX XXXX XXXXXXXXXXXX
XXXX      XXXX           XXX XXXXXXXXXXX
XXXX      XXXXXXXXXX XXXXX    XXXXXXXXXX
XXXXXXXXX XXXXXXXXXX    XX    XXXXXXXXXX
XXXXXXX       XXXXXX                  XX
XXXXXXX       XXXXXX    XXXXXXXXX     XX
XXXXXXXT      XXXXXXXSXXXXXXXXXXXXXX  XX
XXXXXXXXXXX  XXXXXXXXXXXXXX          XXX
XXXXXXXXXXX      XXXXXXXXXX    XXXXXXXXX
XXXXXXXXXXX      XXXXXXXXXX    XXXXXXXXX
XXXXXXXXXXXXXXXXXXXXXXXXXXXXXXXXXXXXXXXX