XXXXXXXXXXXXXXXXXXXXXXXXXXXXXXXXXXXXXXXX
XXXXXX                    XXXXXXXXXXXXXX
XXXXXX XXXXXXXXXXXXXXXXXX XXXXXXXXXXXXXX
XXXXXX XXXXXXXXXXXX       XXXXXXXXXXXXXX
XXXXXX XXXXXXXXXXXX       XXXXXXXXXXXXXX
XXXXXX XXXXXXX XXXX       XXXXXXXX     X
XXXXXX      XX X    XXXXXXXXXXXXXX     X
XXXXXX     TXX               XXXXX XXXXX
XXXXXXXXXXXXXXXXX  XXXXXX XXXXXXXX XXXXX
XXXXXXXXXXXXXXXXX  XXXXXX XXXXXXXX XXXXX
XXXXXXXXXXXXXXXXX  XXXXXX XX       XXXXX
XX      XXXXXXXXX  XXXXXX XXXXXXXX XXXXX
XX      XXXXXXXXX  XXXXXX XXXXXXXX XXXXX
XX      XXXXXX     XXXXXX XXXXXXXX XXXXX
XXXXXXX                            XXXXX
XXXXXXX XXXXX XXXXXX               XXXXX
XXXXXXX XXX      XXX           XXXXXXXXX
XXXXXXX XXX      XXX           XXXXXXXXX
XXXXXXX XXXXX  XXXXX           XXXXXXXXX
XXXXXXX        XXXXXXSXXX XXXXXXXXXXXXXX
XXXXXXX        XXXXXXXXXX XXXXXXXXXXXXXX
XXXXXXX        XXXXXXXXXX            BXX
XXXXXXX        XXXXXXXXXX             XX
XXXXXXXXXXXXXXXXXXXXXXXXXXXXXXXXXXXXXXXX