XXXXXXXXXXXXXXXXXXXXXXXXXXXXXXXXXXXXXXXX
XXXXXXXXXXXXXXXXXXXXXXXXXXXXXXXXXXXXXXXX
XX      XXXXXXXXXXXXXXXXXX         XXXXX
XX XX   X           XXXXXX XXXXXXX XXXXX
XX XX   X   XX      X       TXX       XX
XX XXX XX   XX               XX       XX
XX XX   XX XXX      X        XX       XX
XX XX        XXXX XXXX XXXXX XXXXX XXXXX
XX XX   X    X       X X       XX   XXXX
XX XXXXXXX XXX       X X            XXXX
XX     X    X        X XXXX XXXXX  XXXXX
XX  B  X    X        X XXXX XXX   XXXXXX
XX     X    XXXXXXXXXX        X  XXXXXXX
XXXXXXXXXXXXX                 X  XXXXXXX
X        X            X       X  XXXXXXX
X        X            XXXXXXXXX  XXXXXXX
XXX XX   X      XX    X   P  X        XX
XXX XX XXXXXXXXXXX    X               XX
XXX XX     X     XXXX XXXXXXXXX XXXXXXXX
XXX XX     X     XXXXSXX              XX
XXX XX     X  XXXXXXXXXX        XXXXXXXX
XXX                             XXXXXXXX
XXXXXXXXXXXXXXXXXXXXXXXXXXXXXXXXXXXXXXXX
XXXXXXXXXXXXXXXXXXXXXXXXXXXXXXXXXXXXXXXX