XXXXXXXXXXXXXXXXXXXXXXXXXXXXXXXXXXXXXXXX
XXXXXXXXXXXXXXXXXXXXXXXXXXXX           X
XXXXX              BXXXXXXXXX         XX
XXX                 XXXXXXXXXXXXXX    XX
XX  XXXXXXXXXXXXXXXXXXXX            XXXX
X  XX      TXX     XXXXXXXXXXXXX   XXXXX
X           XX     XXXXXXXXXXXXX   XXXXX
X XXXXXXXXXXXX     XXXXXXXXXXX   XXXXXXX
X  XXXXXXXXXXXXXX XXXXXXXXXX    XXXXXXXX
XX   XXXXXXXXXXXX XXXXXXXX    XXXXXXXXXX
XXXX                        XXXXXXXXXXXX
XXXXXXXXXXXX       XXXXXXXXXXXXXXXXXXXXX
XXXXXXXXXXXX XXXXXXXXXXXXXXXXXXXXXXXXXXX
XXXXXXXXXXX   XXXXXXXXXXXX          XXXX
XXXXXXXXXX      XXXXXXXXXXXX        XXXX
XXXXXXXX         XXXXXXXXXXXXX      XXXX
XXXXXXX          XXXXXXXXXXXXXXX    XXXX
XXXXXX           XXX                XXXX
XXXXXX                              XXXX
XXXXXX           XXXXS              XXXX
XXXXXXX          XXXXXXXXXXXXXXXXXXXXXXX
XXXXXXXXX       XXXXXXXXXXXXXXXXXXXXXXXX
XXXXXXXXXXX   XXXXXXXXXXXXXXXXXXXXXXXXXX
XXXXXXXXXXXXXXXXXXXXXXXXXXXXXXXXXXXXXXXX