XXXXXXXXXXXXXXXXXXXXXXXXXXXXXXXXXXXXXXXX
XX       XXXX       XXXXXXXXXX        XX
XX       XXXX       XXXXX             XX
XX       XXXX       XXXXX XXXX        XX
XX XXXXX XXXX       XXXXX XXXXXXX XXXXXX
XX XXXXX XXXX XXX XXXXXXX XXXXXXX XXXXXX
XX XXXXX XXXX XXX XXX         XXX XXXXXX
XX XXXXX XXXX XXX XXX         XXX XXXXXX
XX XXXXX XXXX XXX XXX         XXX XXXXXX
XX XXXXX XXXX XXX XXX XXXXXXX XXX XXXXXX
XX XXXXX XXXX XXX XXX XXXXXXX XXX XXXXXX
XX XXXXX XXXX XXX XX     XXXX XXX XXXXXX
XX XXXXX XXXX XXX XX     XXXXTXXX XXXXXX
XX XXXXX XXXX XXX        XXXXXXXX XXXXXX
XX XXXXX XXXX XXXXXX     XXXXXXXX XXXXXX
XX XXXXX XX       XX     XXXXXXXX XXXXXX
XX XXXXX XX       XXX XXXXXXXXXXX XXXXXX
XX XXXXX          XXX XXXXXXXXXXX XXXXXX
XX XXXXXXXXXXXXXXXXXX XXXXXXXXXXX XXXXXX
XX           XXXXXXXXSXXXXX        XXXXX
XX           XXXXXXXXXXXXXX        XXXXX
XX         B XXXXXXXXXXXXXX        XXXXX
XXXXXXXXXXXXXXXXXXXXXXXXXXX        XXXXX
XXXXXXXXXXXXXXXXXXXXXXXXXXXXXXXXXXXXXXXX