XXXXXXXXXXXXXXXXXXXXXXXXXXXXXXXXXXXXXXXX
XXXXXXXXXXXXXXXXXXXXXXXXXXXXXXXXXXXXXXXX
XXXXX               XXXXXXXXXXXXXXXXXXXX
XXXXX   XX  XX                 X     XXX
XXXXX   XX  XX      XXXXXX     X  B  XXX
XXXXXXXXXXXXXX      XXXXXXXX XXX     XXX
XXXX    XXXXXXXXX XXXXXXXXXX XXXX   XXXX
XXXX    XXXX       XXXXX      XX    XXXX
XXXX               XXXXX            XXXX
XXXX XXXXXXX       XXXXXXXXXXXXXXXXXXXXX
XXXX    XXXX       XXXXXXXXXXXXXXXXXXXXX
XXXXXXXXXXXX  XXXXXXXXXXX           XXXX
XXXXXXX XX                          XXXX
XXXXXXX XXXXXXXXXXXXX   XXXXXXXXX   XXXX
XXXXX   XXX             XXX         XXXX
XXXXX   XXX      XXX    XXX     XXXXXTXX
XXXXXX  XXX      XXX    XXX XXXXXXXXX XX
XXXXXX           XXXX XXXX  XXX       XX
XXXXXXX   XXXXXXXXXXX XXXX  XXXXXXXXX XX
XXXXXXX   XXXXXXXXXXXSXXX             XX
XXXXXXX   XXXXXXXXXXXXXXXXXXXXXXXXXXXXXX
XXXXXXX  XXXXXXXXXXXXXXXXXXXXXXXXXXXXXXX
XXXXXXXXXXXXXXXXXXXXXXXXXXXXXXXXXXXXXXXX
XXXXXXXXXXXXXXXXXXXXXXXXXXXXXXXXXXXXXXXX