XXXXXXXXXXXXXXXXXXXXXXXXXXXXXXXXXXXXXXXX
XXXXXXXXXXXXXXXXXXXXXXXXXXXXXXXT      XX
XXXXXX XXXXXXXXXXXXXXXXXXXXXXXXX      XX
XXXXXX XXXXXXXXXXXB       XXXXXXXX XXXXX
XXXXXX XXXXXXXXXXX        XXXXXXXX XXXXX
XXXXXX XXXXXXXXXXX        XXXXXXXX XXXXX
XXXXXX      XXXXXXXXXXXXX XXXXXXXX XXXXX
XXXXXXX     XX     XXXXXX XXXXXXXX XXXXX
XXXXXXX            XXXXXX XXXXXXXX XXXXX
XXXXXXX            XXXXXX XXXXXXXX XXXXX
XXXXXXX            XXXXXX XXXXXXXX XXXXX
XXXXXXX XXXXXXXXX  XXXXXX XXXXXXXX XXXXX
XXXXXXX XXXXXXXXX  XXXXXX XXXXXXXX XXXXX
XXXXXXX XXXXXXXXX  XXXXXX XXXXXXXX XXXXX
XX                                 XXXXX
XX XXXX XXXXXXXXXXXXXXXXXXXXXXXXXXXXXXXX
XX XXXX XXXXXXXXXXXXXXXXXXXXXX       XXX
XX XXXXXXXXXXXXXXXXXXXXXXXXXXX       XXX
XX XXXX XXXXXXXXXXXX  XXXXXXXX       XXX
XX XXXX      XXXXXXX SXXXXXXXXXXXXXX XXX
XX XXXX      XX      XXXXXXXXXXXXXXX XXX
XX           XX          XX           XX
XXXXXXX                               XX
XXXXXXXXXXXXXXXXXXXXXXXXXXXXXXXXXXXXXXXX