XXXXXXXXXXXXXXXXXX
XXXXXXXXXXXXXXXXXX
XXXXXXXXXXXXXXXXXX
XXXXX         XXXX
XXXX      XX   XXX
XXXX     XXX   XXX
XXXXXXXXXXXXX  XXX
XXX  X        XXXX
XXX       X    XXX
XXX  X    X    XXX
XXXX X X  XXXX XXX
XXXX XXXXXXXXXXXXX
XXXXXXXXXXXXXXXXXX
XXXXXXXXXXXXXXXXXX
XXXXXXXXXXXXXXXXXX