XXXXXXXXXXXXXXXXXXXX
XXXXXXXXXXXXXXXXXXXX
XXXXXXXXXXXXXXXXXXXX
XXXXXXXXXXXXXXXXXXXX
XXXXXX         XXXXX
XXXXS      OX   XXXX
XXXXX     XXX   XXXX
XXXXXXXXXXXOXX  XXXX
XXXX  XN       XXXXX
XXXX       X    XXXX
XXXX  O    X    XXXX
XXXXX X    X    XXXX
XXXXX XX        XXXX
XXXXX       MO  XXXX
XXXXX   O       XXXX
XXXXX           XXXX
XXXXXXXXXXXXXXXXXXXX
XXXXXXXXXXXXXXXXXXXX
XXXXXXXXXXXXXXXXXXXX
XXXXXXXXXXXXXXXXXXXX