XXXXXXXXXXXXXXXX
XXXXXXXXXXXXXXXX
XXXX         XXX
XXX      XX   XX
XXX     XXX   XX
XXXXXXXXXXXX  XX
XX  X        XXX
XX       X    XX
XX  X    X    XX
XXX X X  XXXX XX
XXX XXXXXXXXXXXX
XXXXXXXXXXXXXXXX
XXXXXXXXXXXXXXXX