XXXXXXXXXXXXXXXXXXXX
XXXXXXXXXXXXXXXXXXXX
XXXXXXXXXXXXXXXXXXXX
XXXXXXXXXXXXXXXXXXXX
XXXXXXXXX      XXXXX
XXXXX   X  XX   XXXX
XXXXXS    XXX   XXXX
XXXXXXXXXXXXXX  XXXX
XXXX  X        XXXXX
XXXX       X    XXXX
XXXX  X    X    XXXX
XXXXX X X  XXXX XXXX
XXXXX XXX  XXXXXXXXX
XXXXXXXXXXXXXXXXXXXX
XXXXXXXXXXXXXXXXXXXX
XXXXXXXXXXXXXXXXXXXX
XXXXXXXXXXXXXXXXXXXX