XXXXXXXXXXXXXXXXXXXXXXXXXXXXXXXXXXXXXXXX
XXXXXXXXXXXXXXXXXXXXXXXXXXXX      B   XX
XXXXXXXXXXXXXXXXXXXXXXXXXXXX          XX
XXXXXXXXXXXXXXXXXX           XXXXX XXXXX
XXXXXXXXXXXXXXXXXX        XXXXXXXX XXXXX
XXXXXXXXXXXXXXXXXX        XXXXXXXX XXXXX
XXXXXXXXXXXXXXXXXXXX XXXXXXXXXXXXX XXXXX
XXXXXXXXXXXXXXXX         XXXXXXX     XXX
XXXXXXXXXXXXXXXX            XXXX   T XXX
XXXXXXXXXXXXXXXX            XXXXXXXXXXXX
XXXXXXXXXXXXXXXX  XXXXXXXXXXXXXXXXXXXXXX
XXXXXXXXXXXXXXXX  XXXXXXXXXXXXXXXXXXXXXX
XXXXXXXXXXX           XXXXXXXXXXXXXXXXXX
XXXXXXXXXXX           XXXXXXXXXXXXXXXXXX
XXXXXXXXXXX           XXXXXXXXXXXXXXXXXX
XXXXXXXXXXX           XXXXXXXXXXXXXXXXXX
XXXXXXXXXXX  XXXXXXXX XXXXXXXXXXXXXXXXXX
XXXXXXXXXXX  XXXXXXXX XXXXXXXXXXXXXXXXXX
XXXXXXXXXXX  XXXXXXXX XXXXXXXXXXXXXXXXXX
XX           XXXXXXXXSXXXXXXXXXXXXXXXXXX
XX                       XXXXXXXXXXXXXXX
XX           XXXXXXXXXXXXXXXXXXXXXXXXXXX
XXXXXXXXXXXXXXXXXXXXXXXXXXXXXXXXXXXXXXXX
XXXXXXXXXXXXXXXXXXXXXXXXXXXXXXXXXXXXXXXX