XXXXXXXXXXXXXXXXXXXXXXXXXXXXXXXXXXXXXXXXXXXXXX
XXXXXXXXXXXXXXXXXXXXXXXXXXXXXXXXXXXXXXXXXXXXXX
XXXXXXXXXXXXXXXXXXXXXXXXXXXXXXXXXXXXXXXXXXXXXX
XXX XXXX    XXXXXXXXXXXXXXXXXXXXXXXXXXXXXXXXXX
XXX  XXX X  XXX   XXXX D   XXXXX   XXXXXXXXXXX
XXXD     X XXXXDX XXXX    DXXXXXXX XXXXXXXXXXX
XXX  XXXXX XXXXXX XXX      XXXXXXX XXXXXXXXXXX
XXXX XXXXX XXXXXX XX  XXX    XXXXX   XXXXXXXXX
XXXXXXXX   XXXXXX     XXXX    XXX  X   X  XXXX
XXXXXXXX   XXXXX  XXXXXXXXXXX XXX XX       XXX
XXXXXXXX  XXXXXX XXXXXXXXXXXX XX  XXX  XXX XXX
XXXXXXXX  XXXXXX XXXXXXXXXXXX    XXXX  XXX XXX
XXXXXX           XXXXXXXXXXX  XXXXXXX  XXXDXXX
XXXXXX    XXX XX XXX         XXXXXXXX  XXXXXXX
XXXXXX X XXXXXXX XXX    V XXXXXXXXXXX  XXXXXXX
XXXXXX XXXXXXXXX          XXXXXXXXXXX   XXXXXX
XXX    XXXXXXXXXX  XX              XXX  XXXXXX
XXX X  XXXXX  XXXXXXX      XXX OOO XXXX  XXXXX
XXX XXXXXXXX   XXXXXX      XXX OOO  XXX  XXXXX
XXX XXXXXXXX X  XXX   X  XXXXX  OOO  XXX   XXX
XXX     XXXXXXX XXX DXX  XXXXXX  OO  XXXX  XXX
XXX XXX    XXXX XXX XXXX XXXXXXX XXX XXXXX XXX
XXX  XXX X XXXX   X XXXX XXXXXXX  X  XXXXX XXX
XXXX XXXXX XXXXXX   XXXX XXXXXXXX    XXXXX XXX
XXXX DXXXX XXXXXX XXXXXX XXXXXXXX XXXXXX   XXX
XXXX  XX   XXXXX  XXXXXX XXXXXXXX XXXXXXD  XXX
XXXXXXX    XX  X  XXXXXX     XXXX  XXXXXX XXXX
XXXXXXXXXX XX XX  XX XXX XXX XXXX  XXXX   XXXX
XXXXXXXXXX XX XX XXX  XX XXX XXXXX XXXX  XXXXX
XXXXXXXX X XX    XXXX XX     XXXXXXXXX   XXXXX
XXXXXX     XXD X XXXX XXXXX XXXXXXXXXX  XXXXXX
XXXXXX X   XXX X      XXXXX XXXXXXXXX  XXXXXXX
XXXXXX XXXXXXXXX XXX  XXXXX XXXXXXXXX  XXXXXXX
XXXX   XXXXXXXXX XXX XXXXXX  XXXXXXXX XXXXXXXX
XXXX XXXXXXXXXXX XXX XXXXXXX  XXXXXXX XXXXXXXX
XXX  XXXXXXXXXXX  XXXXXXXXXXX XXXXXXX XXXXXXXX
XXX  XXXXXXXXXXX  XXXX   XXXX XXXXXXX  DXXXXXX
XXX XXXX   XXX    XXXX X X    XXXXXXXX   XXXXX
XXX XD     XXX   XXXXXDX X XX XXXXXXXXXX XXXXX
XXX XX  XX X X  XXXXXXXX X XXX  XXXXXXXX X XXX
XXX    XXX     XXXXXXXXX   XXXXXXXXXXXXX   XXX
XXXXXXXXXXXXXXXXXXXXXXXXXXXXXXXXXXXXXXXXXXXXXX
XXXXXXXXXXXXXXXXXXXXXXXXXXXXXXXXXXXXXXXXXXXXXX
XXXXXXXXXXXXXXXXXXXXXXXXXXXXXXXXXXXXXXXXXXXXXX