XXXXXXXXXXXXXXXXXXXX
XXXXXXXXXXXXXXXXXXXX
XXXXXXXXXXXXXXXXXXXX
XXXXXXXXXXXXXXXXXXXX
XXXXXX         XXXXX
XXXXX      XX   XXXX
XXXXXS    XX    XXXX
XXXXXXXX  XXXX  XXXX
XXXX  X        XXXXX
XXXX       X    XXXX
XXXX  X         XXXX
XXXXX X X  X    XXXX
XXXXX XXXXXXXXXXXXXX
XXXXXXXXXXXXXXXXXXXX
XXXXXXXXXXXXXXXXXXXX
XXXXXXXXXXXXXXXXXXXX
XXXXXXXXXXXXXXXXXXXX