XXXXXXXXXXXXXXXXXXXX
XXXXXXXXXXXXXXXXXXXX
XXXXXXXXXXXXXXXXXXXX
XXXXXXXXXXXXXXXXXXXX
XXXXXX         XXXXX
XXXXS      OX   XXXX
XXXXX     XXX   XXXX
XXXXXXXXXXXOXX  XXXX
XXXX  XK       XXXXX
XXXX       X    XXXX
XXXX  O    X    XXXX
XXXXX X    X    XXXX
XXXXX XX        XXXX
XXXXX       MO  XXXX
XXXXX   O       XXXX
XXXXXR          XXXX
XXXXXXXXXXXXXXXXXXXX
XXXXXXXXXXXXXXXXXXXX
XXXXXXXXXXXXXXXXXXXX