XXXXXXXXXXXXXXXXXXXX
XXXXXXXXXXXXXXXXXXXX
XXXXXXXXXXXXXXXXXXXX
XXXXXXXXXXXXXXXXXXXX
XXXXXX         XXXXX
XXXXXS     XX   XXXX
XXXXX     XXX   XXXX
XXXXXXXXXXXXXX  XXXX
XXXX  X        XXXXX
XXXX       X    XXXX
XXXX  X    X    XXXX
XXXXX X X  XXXX XXXX
XXXXX XXXXXXXXXXXXXX
XXXXXXXXXXXXXXXXXXXX
XXXXXXXXXXXXXXXXXXXX
XXXXXXXXXXXXXXXXXXXX
XXXXXXXXXXXXXXXXXXXX