XXXXXXXXXXXXXXXXXXXXXXXXXXXXXXXXXXXXXXXX
XXXXXX                          BXXXXXXX
XXXXXX XXXXXXXXXXXXXXXXXXXXX     XXXXTXX
XXXXX    XXXXXXXXXXXXXXXXXXX     XXXX XX
XXXXX          XXXXXXXXXXXXX XXXXXXXX XX
XXXXX       XX XXXXXXXXXXXXX XXXXX     X
XXXXX       XX XXXXXXXXXXXXX XXXXX     X
XXXXX       XX               XXXXX XXXXX
XXXXXXXXXXXXXXXXX  XXXXXXXXX XXXXX XXXXX
XXXXXXXXXXXXXXXXX  XXXXXXXXX   XX   XXXX
XXXXXXXXXXXXXXXXX  XXXXXXXXX        XXXX
XX       XXXXXXXXX  XXXXXXXXXXXXXXX  XXX
XX      XXXXXXXXX  XXXXXXXXXXXXXXX  XXXX
XX      XXXXXX     XXXXXXXXX        XXXX
XXXXXXX                             XXXX
XXXXXXX XXXXX XXXXXX                XXXX
XXXXXXX XXX      XXX   XXXXXXXXXXXXXXXXX
XXXXXXX XXX      XXX   XXXXXXXXXXXXXXXXX
XXXXXXX XXXXX  XXXXX   XXXXXXXXXXXXXXXXX
XXXXXXXXXXXXXXXXXXXXXSXXXXXXXXXXXXXXXXXX
XXXXXXXXXXXXXXXXXXXXXXXXXXXXXXXXXXXXXXXX
XXXXXXXXXXXXXXXXXXXXXXXXXXXXXXXXXXXXXXXX
XXXXXXXXXXXXXXXXXXXXXXXXXXXXXXXXXXXXXXXX
XXXXXXXXXXXXXXXXXXXXXXXXXXXXXXXXXXXXXXXX