XXXXXXXXXXXXXXXXXXXXXXXXXXXXXXXXXXXXXXXX
XXXXXXXXXXXXXXXXXXXXXXXXXXXXXXXXXXXXXXXX
XXXXXXXXXXXXXXXXXXXXXXXXXXXXXXXXXXXXXXXX
XXXXXXXXXXXXXXXXXXXXXXXXXXXXXXXXXXXXXXXX
XXXXX               XXXXXXXXXXXXXXXXXXXX
XXXXX       XX      XXXXXX  T  XX   XXXX
XXXXX       XX      XXXXXX     XX   XXXX
XXXXXXX B XXXX      XXXXXXXX XXXX   XXXX
XXXXXXXXXXXXXXXXX XXXXXXXXXX XXXXX XXXXX
XXXXXXXXXXXX       XXXXX       XX   XXXX
XXXXXXXXXXXX       XXXXX            XXXX
XXXX    XXXX       XXXXXXXXXXXXXXX  XXXX
XXXX    XXXX       XXXXXXXXXXXXXXX  XXXX
XXXX    XXXXXX  XXXXXXXXXXX         XXXX
XXXXXXX XX                          XXXX
XXXXXXX XXXXXXXXXXXXX               XXXX
XXXXX   XXX             XXX         XXXX
XXXXX   XXX      XXX    XXX         XXXX
XXXXXX XXXX      XXX    XXXXXXXXXXXXXXXX
XXXXXX           XXXXSXXXXXXXXXXXXXXXXXX
XXXXXXXXXXXXXXXXXXXXXXXXXXXXXXXXXXXXXXXX
XXXXXXXXXXXXXXXXXXXXXXXXXXXXXXXXXXXXXXXX
XXXXXXXXXXXXXXXXXXXXXXXXXXXXXXXXXXXXXXXX
XXXXXXXXXXXXXXXXXXXXXXXXXXXXXXXXXXXXXXXX