XXXXXXXXXXXXXXXXXXXXXXXXXXXXXXXXXXXXXXXX
XXXXXXXXXXXXXXXXXXXXXXXXXXXXXXXXXXXXXXXX
XX          XX           XXX          XX
XXXXXXX   XXXXXX   XXX   XXX   XXXXXXXXX
XX  XX             XXX   XXX   XX T XXXX
XX  XX    XX       XXX   XXX   XX     XX
XX        XX       XXX         XX     XX
XXXXX     XX       XXXXXXXXXXXXXX     XX
XX        XX   XXXXXXX                XX
XX        XX   XXXXXXX           XX   XX
XX        XX   XX                XX   XX
XX    B   XX   XX      XXXXXXXXXXXX   XX
XX        XX   XXXXX   XXXXXXXXXXXX   XX
XXXXXXXXXXXX      XX   XX             XX
XXXXXXXXXXXXXXXX  XX   XX   XXXXXXX   XX
XX   XX   XXXXXX  XX   XX       XXX   XX
XX   XX       XX  XX   XXXXXX   XXXXXXXX
XX   XX   XX      XX   XX             XX
XX   XX   XX     XXX   XX   XXXXXXXXXXXX
XX   XX   XXXXXXXX     XX             XX
XX                  XSXXX             XX
XXXXXXXXXXXXXXXXXXXXXXXXXXXXXXXXXXXXXXXX
XXXXXXXXXXXXXXXXXXXXXXXXXXXXXXXXXXXXXXXX
XXXXXXXXXXXXXXXXXXXXXXXXXXXXXXXXXXXXXXXX