XXXXXXXXXXXXXXXXXXXXXXXXXXXXXXXXXXXXXXXX
XXXXXXXXXXXXXXX                 XX   TXX
XXXXXXXXXXXXXXXXXX              XX    XX
XXXXXXXXXXXXXXXXXXXXX           XX  XXXX
XXXXXXXXXXXXXXXXXXXXXXX               XX
XXXXXB      XX     XXXXXX             XX
XXXXXXX X          XXXXXXXX           XX
XXXXXXX X        XXXXXXXXXXXX   XXXXXXXX
XXXX    XXXX     XXXXXXXXXXXX  XXXXXXXXX
XXXX XXXXXXXX   XXXXXXXXXXXXX XXXXXXXXXX
XXXX XXXXXXXXX XXXXXXXXXXXXXX XXXXXXXXXX
XXXX XXXXXXXXX                XXXXXXXXXX
XXXX XXXXXXXXXXXXX       XXXXXXXXXXXXXXX
XXXX XXXXXXXXXXX           XXXXXXXXXXXXX
XXXX XXXXXXXXX               XXXXXXXXXXX
XXXX XXXXXXXXX XXXXXX XXXXXXXXXXXXXXXXXX
X               XXXXX XXXXXXXXXXXXXXXXXX
XXXX          XXXXXXX  XXXXXXXXXXXXXXXXX
XXXXXXX     XXXXXXXX    XXXXXXXXXXXXXXXX
XXXXXXXXX XXXXXXXXXXXSXXXXXXXXXXXXXXXXXX
XXXXXXX          XXXXXXXXXXXXXXXXXXXXXXX
XXXXXXXXX       XXXXXXXXXXXXXXXXXXXXXXXX
XXXXXXXXXXX   XXXXXXXXXXXXXXXXXXXXXXXXXX
XXXXXXXXXXXXXXXXXXXXXXXXXXXXXXXXXXXXXXXX