XXXXXXXXXXXXXXXXXXXXXXXXXXXXXXXXXXXXXXXXXXXXXXXX
XXXXXXXXXXXXXXXXXXXXXXXXXXXXXXXXXXXXXXXXXXXXXXXX
XXXXXXXXXXXXXXXXXXXXXXXXXXXXXXXXXXXXXXXXXXXXXXXX
XXXXXXXXXXXXXXXXXXXXXXXXXXXXXXXXXXXXXXXXXXXXXXXX
XXXX XXXX    XXXXXXXXXXXXXXXXXXXXXXXXXXXXXXXXXXX
XXXX  XXX X  XXXD  XXXX D   XXXXX   XXXXXXXXXXXX
XXXXD     X XXXX   XXXX    DXXXXXXX XXXXXXXXXXXX
XXXX  XXXXX XXXXXX XXX      XXXXXXX XXXXXXXXXXXX
XXXXX XXXXX XXXXXX XX  XXX    XXXXX   XXXXXXXXXX
XXXXXXXXX   XXXXXX     XXXX    XXX  X   X  XXXXX
XXXXXXXXX   XXXXX  XXXXXXXXXXX XXX XX       XXXX
XXXXXXXXX  XXXXXX XXXXXXXXXXXX XX  XXX  XXX XXXX
XXXXXXXXX  XXXXXX XXXXXXXXXXXX    XXXX  XXX XXXX
XXXOOXX           XXXXXXXXXXX  XXXXXXX  XXD XXXX
XXXXOOX    XXX XX XXX         XXXXXXXX  XX  XXXX
XXOOOOX X XXXXXXX XXX    V XXXXXXXXXXX  XXXXXXXX
XXXOOOX XXXXXXXXX          XXXXXXXXXXX   XXXXXXX
XXXXY   XXXXXXXXXX  XX              XXX  XXXXXXX
XXXX    XXXXX  XXXXXXX      XXX OOO XXXX  XXXXXX
XXXX XXXXXXXX   XXXXXX      XXX OOO  XXX  XXXXXX
XXXX XXXXXXXX X  XXX   X  XXXXX  OOO  XXX   XXXX
XXXX     XXXXXXX XXX DXX  XXXXXX  OO  XXXX  XXXX
XXXX XXX    XXXX XXX  XXX XXXXXXX XXX XXXXX XXXX
XXXX  XXX X XXXX   X XXXX XXXXXXX  X  XXXXX XXXX
XXXXX XXXXX XXXXXX   XXXX XXXXXXXX    XXXXX XXXX
XXXXX DXXXX XXXXXX XXXXXX XXXXXXXX XXXXXX   XXXX
XXXXX  XX   XXXXX  XXXXXX XXXXXXXX XXXXXXD  XXXX
XXXXXXXX    XX  X  XXXXXX     XXXX  XXXXX  XXXXX
XXXXXXXXXXX XX XX  XX XXX XXX XXXX  XXXX   XXXXX
XXXXXXXXXXX XX XX XXX  XX XXX XXXXX XXXX  XXXXXX
XXXXXXXXX X XX    XXXX XX     XXXXXXXXX   XXXXXX
XXXXXXX     XXD X XXXX XXXXX XXXXXXXXXX  XXXXXXX
XXXXXXX X   XX  X      XXXXX XXXXXXXXX  XXXXXXXX
XXXXXXX XXXXXXXXX XXX  XXXXX XXXXXXXXX  XXXXXXXX
XXXXX   XXXXXXXXX XXX XXXXXX  XXXXXXXX XXXXXXXXX
XXXXX XXXXXXXXXXX XXX XXXBXXX  XXXXXXX XXXXXXXXX
XXXX  XXXXXXXXXXX  XXXXXX XXXX XXXXXXX XXXXXXXXX
XXXX  XXXXXXXXXXX  XXXX   XXXX XXXXXXX  DXXXXXXX
XXXX XXXX   XXX    XXXXXX X    XXXXXXXX   XXXXXX
XXXX XD     XXX   XXXXXDX X XX XXXXXXXXXX XXXXXX
XXXX X   XX X X  XXXXXX X X XX  LXXXXXXXX X XXXX
XXXX    XXX     XXXXXXX     XXXXOOOXXXXXX   XXXX
XXXXXXXXXXXXXXXXXXXXXXXXXXXXXXXOOOOOOOXXXXXXXXXX
XXXXXXXXXXXXXXXXXXXXXXXXXXXXXXXXOOOOOOOXXXXXXXXX
XXXXXXXXXXXXXXXXXXXXXXXXXXXXXXXXOOOOOOXXXXXXXXXX
XXXXXXXXXXXXXXXXXXXXXXXXXXXXXXXXXXOOOXXXXXXXXXXX